














                                     
                                  #####################
                            #################################
                            ######################################
                            ###########             #################
####################################                   ################
###################################                     #################
###################################                     ################## 
####################################                  ######################
#######################################             #####  ###################
#########################################################     ##################
##########################################################       ###############
                                                                    ############